allah	Tuhan Yang Maha Esa
alif	Huruf yang pertama dalam susuna tulis Melayu
aba	Bapak
abar	Kendur
abrak	Satu jenis batu seperti keadaan cermin tetapi boleh digulung
ab'ad	Pekerjaan sunat yang besar
abang	Saudara tua
abu	Baki yang hangus
atap	Bubung rumah
atau	Salah satu
atur	Susun
atung	Berkatung-katung
ajar	Tunjuk
ajak	Jemput yang ikhlas
ajnas	Berbagai-bagai
ajal	Waktu yang ditentukan
aji	Haji
acara	Acara
acar	Sayur yang ditumis
acap	Hapus
acap kali	Selalu
acu	Cetakan kueh
acup	Tenggelam sedikit daripada muka air
acum	Asut
acah	Gerakan seperi menerkam 
aci	Gandaran roda
aci	Saudara perempuan
ahad	Minggu
ahsan 	Lebih bagus
ahmad	Nama Nabi muhammad
ahmar	Merah
ahmak	Bodoh bebal
akhun	Saudara laki-laki
akhbar	Beberapa Perkabran
akhir	Kemudian
akhir al-zaman	Masa penyudahan
akhdar	Hijau
akhi	Saudara ku
ada	Hadir
adakah	Menanyakan ada atau tidak
adalah	Memperihalkan
adanya	Penghabisan kata
adab	Perangai yang baik
adiraja	Diraja
adang	Tahan
adap	Menghadap
adipati	Gelaran pemerintah disebelah tanah jawa
ada pula	Dan juga
adinda 	Adik
adu	Lawan
adun	Campur
aduni	Hiasi
adi	Yang terutama
aduh	Mengeluh
aduhai	Seruan Pilu
adoi	Teriakan sakit
adik	Saudara Muda
azan	Seruan bagi yang semahyang
ara	Kayu besar
iradah	Kehendak
arau	Utas jaring bagi penangkap ikan
arjuna	Nama orang yang gagah
arca	Kota mara
arang	Bekas bakaran yang hitam
arak	Minuman yang memabukkan
arkan 	Rukun-Rukun
aram	Dendam
armada	Pasukan kapal perang
arnab	Kucing belanda
aruah	Roh
aruan	Ikan darat
arah	Anggaran tempat
ari	Hari
ari-ari	Kakak bayi
arit	Gores
aring	Halwa kabung
arik	Bengkok
asa	Harap hati
asad	Singa
asap	Hawa daripada ap
asak	Tekan padat-padat
asal	tempat tinggal
asam	Asam jawa
asmara	Cinta
asu	Anjing
asut	Mengubah fikiran daripada suka jadi benci
asuh	Pelihara anak kecil
asah	Gahar
aswad	Hitam
asai	Memakan diri
asing	Lain
ashad	Tuan-tuan punya
asli	Yang asal betul
atlas	Peta
angsa	Sejenis Itik
angka	Tanda bilangan
angkatan	Pergerakan
angkar	Dedar
angkak	kue berisi daging
angkut	Angkat
angkut-angkut	Sarangulat dari tanah
angkosa	Kosa gajah
angkup	Penjepit 
angkuh	Tiada kuat
angkah	Teragak
angkit	Bangkit
anglo	Dapur
angan-angan	Cita-cita
angin	Udara
angin-angin	Fentilasi Udara
angguk	Mengangguk
anggur	Buah Anggur
anggun	Rupa cantik 
apabila	Tatkala mana
april	Bulan keempat dalam kalender masehi
apak	Bau yang tidak enak
apam	Kueh apam
apung	Mengapung
api	Api
apit	Apitan
apek	Orang tua
akrab	Dekat
akar	Cabang kayu didalam tanah
akas	Cergas: pantas
aksara	Suatu huruf
akmal	Lebih Sempurna
akan	Nanti
aku	Saya
akuan	Mengaku
aki	Datuk
agama	Kepercayaan
agar-agar	Jely
agas	Sejenis nyamuk tapi bukan nyamuk
agak	Sangka
agak-agak	Fikir-fikir
agam	Besar
aguk	Rantai leher
agih	Tiada senonoh
alba	Rempah
alat	Peralatan
alas	Alas
alang	Pak Alang
alang kepalang	Terangkat-angkat
alfa	Tida hadir
al-quran	Kitab suci
al-kisah	Suatu cerita
almari	Lemari
almarhumah	Roh perempuan
alu	Antan bagi lesung
alur	Aluran
alah	Tewas
ali-ali	Tali peluntur
alit	Tali gasing
alir	Jalar
alis	Bulu yang dimata
alik	Ringkasan perkataan balik
alih	Pindah
alih-alih	Tiba-tiba
ama	Mama
amati	Perhatikan
amarah	Kemarahan
aman	Sentosa
amanah	Kepercayaan
ambaru	Penahan tambak
ambai	Penangkap ikan
ambar	Tawar
ambang	Kayu melintang bagi pintu
ambon	Nama pisang
ampas	Sisa pati
ampar	Bentang 
ampu	Mengampu
ampun	Maaf
ampai	Gantungan Baju
amuk	Mengamuk
ammonia	Bahan keras
antah	Beras berantah
anting-anting	Perhiasan telinga
anbia	Nabi-nabi
anta	Engkau laki-laki
anti	Engkau perempuan
antara	Selang sama tengah
anjang	Panjang
antil	Terbuai-buai
anjar	Tali penarik layar
anjak	Kisar
anjang-anjang	Sejenis ikan
anjit	Banyak Ragam
anjing	Sejenis binatang
anda	Sebutan untuk orang yang belum dikenal
andar	Cuma
andang	Dandang
andam 	Berandam/bermake up
ansur	Duluan
anak	Anak
anam-anam	Buah namnam
anum	Nama orang yang muda
anai-anai	Sarang semut
aniaya	Zalim
aneka	Macam-macam
anyabah	Tiada senonoh
awang-awang 	Tak sampai keatas atau kebawah
awak	Kamu
awan	Mega wap yang sudah menjadi titik air halus bergumpal tinggi diatas awan
awah	Upaj separuh dibayar dan separuh nanti bila ada untung
awai	Sia-sia
aula	Lebih utama
ayan	Tin timah yang dicampur dengan besi
ayam 	Ayam
ayu	Cantik
ayuta	Juta
ayun	Berayun
ayuh	Seruan Mengajak
ayuhai	Seruan pilu
ayah	Bapak
ayahanda	Ayah bagi maksud kehalusan dan hormat
anyar	Halus
anyam	Menyelimpat tikar atau bakul
anyu	Lecah atau lumpur yang kena lanyak
anyis	Unyas anyis
anyih	Meleret
ba	Huruf kedua hijaiyah
bab	Pasal
baba	Anak baik
babat	Nama orang laki-laki
babar	Mengembangkan layar
babas	Terlepas  ketempat lain
babak	Nama orang
babil	Nama sebuah negeri
babu	Pembantu
babi	Binatang yang haram
babi tunggal	Babi hutan jantan besar
bata	Batu Bakar
batang	Pohon
batak	Suatu jenis bangasa dalam pulau perca
batu	Sejenis benda keras
batu asah	Alat untuk mengasah pisau
batu api	Orang yang berfi'il jahat menaikkan panas hati orang
batu emas	Batu yang berkilat-kilat seperti keadaan emas
batu ali	Batu menjadi perejam
batu arang	Arang batu
batu ubin	Batu bakar lepa jadi lantai
batu belah	Batu besar yang terbelah
batu delima	Permata yang berwarna merah
batu zamrud	Permata yang berwarna hijau
batu akik	Batu permata yang dijadikan cincin
batu pertama 	Permata yang bukan daripada kaca
batu puhalam	Batu marmar
batu karang	Batu yang ada di dasar laut
batu kapur	Batu yang di dapati
batu kepala	Tempurung kepala
batu kelikir	Batu yang merah dan bersarang-sarang
batu giling 	Batu yang dijadikan tempat menggiling
batu nilam	Permata yang berwarna biru
batu hampar	Batu yang rata
batu hitam	Batu yang berwarna hitam
batu ladung	Timah pemberat tali kail
batung 	Sejenis siput
batuk	Penyakit tenggorokan
batuk kering	Batuk yang berdengking
batuk kokok	Batuk sesak
batik	Kain berbunga 
batil	Pandu atau penimbang jong
batin	Gelaran kampung diantara orang melayu berpangkat
baja	Besi baja
bajang	Hantu anak-anak yang mati pada zaman dahulu
bajak	Alat membalikkan tanah
baju	pakaian
bajau	Tempayan
baji	Perkakas bagi merenggangkan belahan kayu
bajing	Sejenis terendak
baca	Bunyikan perkataan yang tersebut
bacar	Banyak cakap
bacir	Bucar sangat
bacang	Buah daripada jenis mempelam atau kuini
bacuk	Buluh bekas bagi mengisi nira atau air
bacul	Penakut
bacin	Bau yang tiada sedap seperti bau belacan
biadap	Tidak sopan
badang	Sejenis nyiru yang bulat
badak	Sejenis binatang yang tebal kulit nya
badam	Sejenis buah ketapang
badan 	Tubuh anggota
badun	Orang kelakar dalam wayang
badi	Terkena suna
badik	Sejenis pisau senjata yang kecil
bara 	Arang yang bernyala
barat	Sebelah matahari masuk setelah magrib
barat daya	Antara barat tepat dengan selatan
barat laut	Antara barat dengan utara
barang	Benda
barang kali	Boleh jadi
baraka	Barakallah
baran	Hutan paya
barau	Nama sejenis burung
baru-baru	Nama sejenis pokok tepi laut seakan-akan mahang
barut	Pembalut perut
barus	Kapur yang berbau keras
baruk 	Nama satu kaum bangsa orang laut
baruh	Tanah dekat tepi sungai
barah	Penyakit seperti bisul
barai	Sejenis lokan besar matanya
bari-bari	Binatang yang suka terbang dilampu
baring	Rebahan
barik	Berbelang yang berurat atau berbelak-belak
berek	Rumah tempat askar
basal	Sejenis penyakit bengkak atau sembab
basau	Rasa masuk  angin pada kelapa
basuh	cuci dengan air
basah	Kena air
basi	Berubah rasa
basha	Gelaran orang besar
basar	Yang melihat lebih
batin	Yang sulit
batal	Tiada pakai
bangat	Segera
bangar	Sejenis bau tidak sedap
bangau	Sejenis unggas kaki panjang
bangun	Bangkit
bangunan	Rumah 
bangai	Kebiaran
baki	Yang tinggal
baka	Asal keturunan bagi benda yang bernyawa
bakat	Bekas
bakar	Membakar
bakal	Cadangan
bakau	Pohon bakau
bakung 	Sejenis pokok yang berdaun panjang dari tanag dan bunga nya putih
bakup	Bengkak
bakul	Bekas untuk mengangkat barang
bakir	Basi
bakik	Sejenis pokok menjalar dan buah nya dimakan seperti sirih
bagar	Besar
bagan	Pangkalan
bagus	Cantik
bagung	Besar
bagi	Untuk
bilhaq	Dengan benar
balar	Putih kemerah-merahan
balas	Beri balik
baliqh	Sampai umur
balang	Botol besar istimewa
balak	Kayu besar sudah dipotong
billah	Dengan nama Allah
balam	Sejenis Burung
balau	Kayu
balu	Bujang terutama pada perempuan yang telah mati suami
balut	Bungkus
balung	Pial Ayam
baluk	Sejenis perahu
balung	Bantai
baluh	Kulit
baluhan	Rangka tempat duduk
baloi	Sama merasa
balah	Bangkang
balai	Rumah pasung
bali	Nama pulau dekat jawa
balairung	Balai dalam istana
baling	Senget
balik	Pulang
banang	Besar
banir	Pangkal akar 
bawa	Angkat pergi ketempat lain
bawa mulut	Berbicara kesana kesini
bawaan	Keadaan,gaya
baut	Pusing layar
baur	Bercampur gaul
baup	Bukup
bauk	Jambang
bawang	Bawang
bawang benggala	Bawang besar
bawang putih	Bawang berwarna putih
bawang kucai	Bawang yang digunakan daunnya terutama seperti sayur
bawang merah	Bawang berwarna merah
bawal	Ikan bawal
bawah	Lawan atas
bawah angin	Dilindungi oleh sesuatu yang kena angin
bahang	Uap panas
baham	Makan dengan keadaan gelojoh
bahan	Pukul
bahu	Anggota antara leher dengan pangkal lengan
bau	Rasa  
baya	Sebaya
bidara	Sejenis pohon
berbelit	Berbilit
berbual	Bercakap-bercakap kosong
bertih	Padi yang di goreng 
beras	Isi padi
beranak	Bersaling
beresut	Masam muka
bersalaman	Berjabat tangan
bersit	Terpacul
bersin	Bersin
bersih	Tidak kotor,suci
berenga	Telur langau
berangta	Bercinta
berak	Buang Air Besar
berkenan	Setuju
berembang	Sejenis pohon ditepi sungai
beremban	Nama sejenis pokok
bermula	Mulai
bermi	Nama sejenis rumput dekat air
brandi	Minuman yang mabuk
bernas	Gemuk
berenang	Berenang
berniaga	Berjual beli
beruti	Papan yang tidak lebar
berus	Perkakas pembersih
beruk	Sejenis monyet
beritahu	Menyatakan
bering-bering	Bunyian yang bising
beringin	Pohon besar
bas	Kereta besar
biskuit	Roti keras
basikal	Sepeda
bangsal	Rumah panjang bagi sementara
bangsi	Sejenis serunai
bankrap	Tidak terbayar hutang
bengkarung	Sejenis cicak
bengkawan	Alat untuk membuat atap
bangkai	Binatang yang mati
bengkalis	Pulau bengkalis
bangkit	Bangun
banggul	Timbul
benguk	Bengkok
bengah	Duduk dengan meninggikan badan
bengis	Naik marah
bekal	Makanan yang dibawa diperjalanan
beku	Keras
belebas	Kayu melintang bagi dinding
belebau	Belasah
belebat	Nama kuih dari pada ubi dikukus
belat	Sejenis Kelong
baldi	Timba dari timah sari
belas	Kasihan
belangkas	Sejenis ketam yang besar
belenggu	Rantai besar
belak	Coreng-coreng
belemang	Nama sejenis kuih pulut
belantik	Jerat
belut	Ikan yang panjang
belukar	Hutan muda
belukang	Ikan yang berduri
belulang	tulang binatang
belibit	Tepi kain yang bergulung
belibis	Sejenis itik yang besar
belit	Lilit keliling
belerang	Tanah atau batu warna nya kuning
belikat	Arah belakanga bertentangan dengan dada
belimbing	Benda-benda yang bergelugur
bantut	Kueh tak jadi
bentan	Berbalik sakit
bantah	Larang
bancuh	Melarutkan
benci	Tidak suka
benderang	Terang
bendul	Kayu pemidang rumah
benak 	tiada tajam otak
benam	Tekan
bani	Kaum
benih	Biji atau anak daripada pokok yang hendak ditanam
banin	Saudagar
benyek	Lembut
buas	Garang
buak-buak	Naik menggelegak
bual	Berbicara
buah	Buah
buah pinggang	Daging
buah mata	Pandangan orang
buah mulut	Percakapan orang
buah hati	Yang dikasihi
buah hulu	Bahulu
buai	Ayunan
bubu	Perangkap ikan
bot	Perahu kecil
butang	Kancing
botak	Tak berambut
bujut	Kusut
butut	keretot
bujangga 	Bujang
bujal	Terjojol
buci	Fikiran yang sempurna
bocor	Berlubang
bujuk	Sejenis ikan dari pada jenis haruan
bocong	Kendi tiada tutup
bucu	Penjuru
budak	Anak-anak
budak sekolah	Anak sekolah
bodot	Seakan-akan bodoh
bodoh	Dungu,tolol,bebal,bingung
budi	Pemberian
budi bahasa 	Baik pekerti
bodek	Buah kemaluan yang besar sebab penyakit
boros	Tidak hemat
borang	Lakar
burung	Unggas yang terbang
burak	Buka
buru	Kejar
borong	Ikat upah
buruk	Rusak
burai	Terkeluar
boria	Permainan bernyanyi
burit	Lubang tongkeng
borek	Jenis bulu ayam yang bercampur putih
boreh	Beras dibasuh kemudian digiling jadi bedak
bokek	Tiada kuat
bogok	Gemuk
bogi	Sejenis kereta kenaikan empat roda ditarik oleh kuda
bogel	Telanjang 
bolang-baling	Pusing angin
bulak	Bukan
bulur	Kelaparan
bolos	Licin
bolong	Lantas
buluh	Bambu
boleh	Boleh
bolok	Bengkak
buli-buli	Bekas yang bulat lagi kecil
bumbung	Kemuncak rumah
buntuk	Pendek
bunting	Mengandung
bunting sarat	Bunting hampir akan melahirkan
bunting pelamin	Kahwin-kahwin sahaja terus hamil
bunting kerbau	Lebih dari 9 bulan
bonjol	Bengkak terjojol
buncis	Nama sejenis kacang
buncit	Perut besar
bunian	Orang halus
bahwasanya	Sesungguh nya
bela	Pelihara
belatuk	Nama sejenis burung
belacan	Sejenis perencah dari udang yang dihancurkan dan dikeringkan
belacu	Kain putih benang mentah
belading	Sejenis parang lentik
belasah	Mukul orang
belanga	Tempat masak nasi
belalak	Terbuka besar
biang	Gatal,sundal,nakal
bibir	Tepi mulut
bibit	Biji benih
becok	Riuh,berisik
bidas	Bahasa dalam permainan gulu
bidang	Lebar Pada dada
biduan	Penyanyi panggung
biduk	Suatu jenis perahu
baiduri	Sejenis permata
birat	Bekas kena pukul
berang	Panas hati
berak	Buang air besar
biram	Warna gelap
berot	Tidak lurus
bini	Istri
biuku	Sejenis kura-kura
benyai	Nasi yang tidak masak
belot	Tidak setia
cabar	Mencabar
cabang	Cuba
cabut	Keluar
cabut undi	Menentukan pendapatannya ikut nasib
cabus	Kosong
cabuk	Cemeti
cabul	Mencabul
cabai	Cabe
cabir	Koyak berkeping keping
cabik	Koyak yang kecil tetapi tidak putus cebisnya
catu	Beri sedikit-sedikit
catur	Nama sejenis permainan
cacat	Rusak
cacar	Sakit ketumbuh
cacar air	Sakit akan akan ketumbuh tetapi tiada bahaya
cacing	Ulat yang panjang 
cadar	Kain alas tidur
cadang	Cadangan
carut	Bilang kotor
caru	Nama ikan
capak	Mudah
caping	Penekup urat hdapan bagi anak-anak
cakar	Ragas
cakap	Tutur kata
cakuk	Kait
cagar	Mencagarkan
cagu	Sejenis kudis
canguk	Duduk menunjukkan kepala
capak	Mudah
capai	Diambil atau pegang benda jauh dengan hujung  tangan
cawat	Celana dalam untuk bayi
caing	Koyak berkeping-keping
cair	Sifat yang boleh mengalir
cebur	Bunyi jatuh kedalam air
ceratuk 	Duduk beramai-ramai
ceroboh 	Melanggar aturan
cerut	Ikat rapat dan terik
ceruh	Rendam
cerah	Terang
cerai	Berpecah
ceridau	Keliau
cerewet	Banyak kehendak
cengkaruk	Nyiur muda dicakar ditaruh airnya
cengang	Kelakuan menunjukkan hairan
cengap	Bunyi makan
cengkerik	Sejenis binatang yang bunyi nya nyaring
cengkang	Bertengkar
cengkam	Dipegang kuat terutama kalau dengan jari yang berkuku
cangkir	Cawan
canggung	Sumbang
canggai	Kuku panjang
cekah	Buka,koyakkan
ceking	Tahan belanja
cegat	Tercancang
celebur	Terjun kedalam air
celak	Pantis atas mata atau bibir mata
celempung	Bunyi air
celoteh	Bercakap bermacam-macam
celur	Rebus
celupar	Cakap yang tiada berjaga
celumis	Pengotor
celah	Antara dua benda yang hampir atau rapat
celis	Tiada cukup makan
celengkok	Lengkung,bengkok
celik	Terbuka mata
cemik	Muka mencebik
cinta	Bercinta
cencaluk	Nama sejenis pekasam udang yang halus
cencorot	Sejenis binatang terbesar dari pada cengkerik
cincing	Lari muting
cincin	Lengkang pakai di jari
cendawan	Sejenis tumbuhan terutama pada kayu mati
candat	Sejenis mata kail yang berpeluntang
cuai	Lalai
cubak	Koyak
cubit	Sepit dengan jari
cobek	Tempat melecek garam atau lada
cutuk	Duduk beramai
cuit	Hujung yang kecil
cuca	Ditahan
cucur	Sejenis kuih dari pada tepung beras
cucu	Anak kepada anak
cuci	Basuh
codak	Hujung terangkat
curam	Rendah sebelah
corot	Tinggal kebelakang
corong	Serombong
curah	Tuang
congkak	Sombong
cup	Semula tak jadi
cup tui	Tidak aci(dalam bahasa permainan)
cup naik	semua karena tersalah
cupak	Sukatan dua leng dan empat cupak jadi satu gantang
cupu	Lubang yang tohor disediakan bagi tumpu perdirian
cupur	Tepi sangat
cupis	Terlampau ketepi tapi boleh jadi pecah
cuping	Daun telinga
cupil	Hampir sangat ketepi dekat hendak jatuh
cuka	Sejenis air yang masam
cukup	Penuh
cokok	Bersuka-suka masa mandi
cukai	Bayaran yang ditentukan oeh kerajaan bagi menjadi hasil negeri
cogat	Terdiri tegak ditengah lapang
cogan	Alamat
colok	Sumbu bagi api yang boleh hidup lama dengan tiada menyala
colek	Ambil sedikit dengan ujung jari
compang	Koyak
compes	Pecah ditepi
comot	Kotor sedikit
comel	Kecil dan manis
conteng	Mengecat muka
cebok	Gayung
cicah	colek jamah sedikit
cicit	Anak kepada cucu
cicir	Jatuh
cicik	Tak berkenan
cedok	ambik dengan suatu bekas
cirit	Nama sejenis lauk dari pada telur ikan
cerek	Bekas air yang bermuncung
cengkong	Lengan tangan tak boleh lurus
daba	Bau yang keras
dabus	Besi yang matanya pendek
dabung	Memapar atau memotong
datar	Rata
datang	Hadir
datuk	Bapak kepada bapak
datia	Gergasi
datin	Gelaran keatas ahli
dacing	Sejenis alatan menimbang
dadar	Bahagi rata-rata
dadak	Pekak yang berlebih
dadu	Sejenis buah permainan
daduk	Bertunggu meminta
dadah	Kacukan dari pada dadar
dara	Anak perempuan yang telah cukup umur belum bersuami
dagu	Anggota yang dibawah muka
dalang	Tukang jalankan hal atau cerita terutama dalam permainan wayang kulit
dalal	Tukang jual
dalam	Lawan luar
dalik	Beralih
dalih	Bersangkal jawab
dialih	Berubah tempat
damar	Getah kayu diperbuat suluh dibakar
damak	Anak sumpitan
daman	Tali kelat pada layar
damai	Selesai,berbaik-baik
danur 	Tanah dan darah yang busuk
dawat	Tinta
dawai	Tali tembaga atau timah sari
farak	Beza
fasik	Jahil ataupun sengaja jahat
fatimah	Nama Perempuan
fa'il	Yang berbuat
faedah	Guna
fataha	Mulai
fathah	Baris atas
fitnah	Benda yang tiada dikatakan ada berlaku
fatwa	Hukum daripada mufti
fajar	Cahaya
fidyah	Bayaran
faraj	Kemaluan perempuan
firdaus	Surga
fardu	Perkara yang wajib
fir'aun	Raja mesir
firqah	Pihak yang terpecah dan berasing-asing
firman	Perintah Tuhan
fasal	Bagian
fasih	Betul sebutan huruf serta lancar
fadal	Kalau bermakna
fuduli	Mencampuri
fadilat	Kebajikan
fakir	Yang kurang mampu
fikir	Timbangan akal
fana 	Binasa
faham	Mengerti
falah	Kekal dalam kemenangan
fulan	Si Anu
ghalib	Kebanyakan
ghaib	Lenyap
gharib	Orang luar
ghurub	Matahari masuk
ghazali	Nama imam
ghazal	Gurindam
ghafur	Yang amat mengampuni
ghalat	Salah
ghunnah	Bunyi menghidung mendengung
ghulam	Budak-budak
ghain	Ejaan nama huruf
gajus	Nama sejenis pokok jambu
gajah	Binatang darat yang besar sekali
gaji	Upah kerja
gaduh	Pertengkaran yang besar
gadai	Meletakkan barang kerana cagaran meminjam uang
gading	Taring gajah
gado-gado	Sejenis rujak makanan orang jawa
garu	Dikukut dnegan kuku bagi menghilangkan gatal
garau	Suara kasar dan keras
gasak	Buat sesuatu  dengan kuat dan kasar
gasing	Permainan yang dipusing
gapah	Pasangan bagi gopoh
gagang	Tangkai
gagau	Teraba-raba
galak	Garang
gali	Buat lubang
gaung	Celah bukit yang curam
gahar	Ganyah
gayang	Bergoyang badan
gayung	Pencedok air
ganyut	Keras pada ubi
gebur	Kembang dan gembur
getis	Memotobg bunga atau pucuk kayu
gedabah	Suatu sunting yang berjurai dipakai oleh pengantin
gedebak	Bunyi jatuh di atasa tanah
geraham	Gigi yang besar dibelakang
gertang	Keras
gertak	Ugut
gertuk	Bunyi seperti mengetuk atau berantuk
geram	Rasa hendak membuat apa-apa seperti berdendam
gerigut	Terkokol
gerigis	Bergigi-gigi banyak
gerinsing	Rambut kering
gegap	Gugup
gelanggang	Tempat bertanding
gelak	Tertawa
gelepai	Terjuntai
gelojoh	Kuat makan
gelut	Berhempas
gelosor	Melorot
gelugur	Jatuh kebawah
gelupur	Menghempas kerana hendak lepas atau hendak mati
gelupas	Tersoyat kulit seperti terkopes
gelokak	Pecah kulit serta kering
gelugut	Menggeletarkan karena takut sejuk
gelugur	Sejenis pokok dan buahnya masam
geluncur	Melorot turun seperti pada batang atau beting yang licin
gelonsor	Luncur
geli	Jijik
geliat	Menegangkan urat bdan ketika bangun tidur
geletek	Cucuk dengan hujung jari menjadikan seorang naik geli dan tertawa
gelecek	Menggelasar pada tempat licin atau curam
gelenggang	Sejenis dayn yang jadi ubat kurap atau ketiak yang berbau
gelekek 	Ketawa berlebih-lebih dan berbunyi kek-kek
gambus	Sejenis kecapi
gambir	penambah makanan untuk makan sirih
gentar	Takut
gantang	Sukatan empat cupak
gantung	Ditambat keatas dan benda yang ditambat itu tidak jejak kebawah
guruh	Bunyi yang menderu atau menderam
guri	Takar kecil
gorek	Sejenis buah yang jadi ubat
gusar	Susah hati
gosok	Ganyah,sapu dengan keras
gonggong	Gigit dibawa lari
gopoh	Hendak lekas
gugup	Riuh
gogok	Potong leher
golok	Senjata sepert tumbuk lada tetapi besar
gomol	Gigit berpusing-pusing
gundah	Sayu hati
guni	Karung
gulana	Gelisah berlebihan
goyang	Goncang
gonyel	Gigit dan kunyah dengan isi nya
gigil	Menggelatuk kerana sejuk atau takut
gemol	Gemuk
gentel	Gelek dengan anak jari dengan perlahan-lahan
genjang-genjot	Serong menyerong
gincu	Lipstik
habis	Selesai
habur	Tidak hemat
habuk	Debu
hadap	Halakan muka kepada sesuatu
harang	Bekas kayu yang terbakar
harap 	Mengharapkan
haru	Kacau
harung	Air dalam laut hingga arusnya pun keras
haruk	Amuk
hari	Waktu
hangat	Panas
hangit	Bau yang tidak sedap
hapit	Diletakkan diantara dua benda kemudian yang ditekan
halau	Suruh pergi dari suatu tempat dengan keras
halang	Sekat
hama	Binatang kecil
hamun	Maki
hamis	Bau seperti bau itik,kambing
hawa	Udara
hawar	Musim penyakit binatang 
haus	Dahaga
hayuk	Ayo
hanyut	Berjalan dibawa oleh air mengalir
hanyir	Bau atas rasa seperti ikan mentah
habuan	Bahagian
hebah	Pemberian
hijrah	Berpindah
hadapan	Pindah arah kesebelah muka
hartawan	Orang yang berharta
herdik	Bercakap dengan keras seperti orang marah
harloji	Jam kocek atau jam tangan
hadam	Hancur makanan dalam perut
hulu balang	Orang-orang termasyur gagah
haluan	Tujuan
halimun	Ilmu boleh menjadikan dirinya tidak nampak
hamba sahaya	Orang-orang yang ditebus 
hempedal	Ampela 
hempas	Campak kebawah
hampang	Ringan
hempalas	Daun yang kesat buat penggosok supaya licin
hamlar	Lawak
hantu	Benda ghaib
hantuk	Kenakan
hancur	Jadi lumat
hancai	Pecah
hancing	Bau sepeti jengkol atau kencing
hendak	Mahu
hindu	Bangsa india
hanuman	Dewa yang berupa monyet
hubung	Sambung
hutang	Barang yang diambil atas kira-kira
hodoh	Tiada molek
hogah	Goyang akan benda tercacak
huyung	Condong tergoyang-goyang
hias	pakaikan benda yang menambah elok pada pemandangan
hiba	Pilu perasaan
hebat	Kacak
hibur	Menghilangkan duka
heboh	Bising dan besar serta kacau bunyinya
hitam	Warna gelap
hitung	Bilang
heja	Merangkai huruf
hidung	Anggota penciuman pada muka
hidup	Bergerak
herang-herot	Bengkok-bengkok
hirup	hisap air masuk kemulut dengan berbunyi
heret	Tarik
hisap	Menghisap
hingar	Buat bising
hinggap	Bergerak ketepi
hengot	Jadi terbengkok
hingus	Lendir yang keluar dari hidung
helak	Melepaskan dari pada kena apa-apa
hailam	Suatu kaum bangsa cina yang datang dari negeri pulau Hainan
himbas	Angin bagi sesuatu benda yang lalu
hemat	Jaga
hina 	Rendah dan keji
hinjit	Banyak perintah
henyah	Halau
lebat	Banyak buah
lebar	Bunyi benda besar terjun dalam air
laberang	Tali yang meregang kiri kanan tiang kapaln supaya menguatkan
lebak	Bunyi buah gugur
lebam	Merah kehitam-hitaman
leban	Nama sejenis pokok ditepi laut
lebau	Pukul
lebu	Debu
lebur	Hancur
lebus	Bunyi benda telus kebawah
lebuk	Bunyi buah atau barang bulat gugur ketanah
lebun	Rosak
lebih	Mengatas pada bilangan atau kadar
lebai	Lebai
lebik	Bunyi dipukul ditengah belakang atau benda lembut jatuh ketanah
labbaik	Menurut perintah
leta	Rusak 
letas	Bunyi cemati
letas-letus	Bunyi meletup kecil-kecil
letap	Bunyi patah ranting atau dahan kecil
letur	Bakar bnyak-banyak seperti panas
letup	Bunyi seperti bedil
letik	Bunyi halus seperti cicak
lerai	Ceraikan orang berkelahi
las	Batu penggilap
lesap	Hilang ghaib
lesu	Lemah-lemah rasa badan
lesung	Tempat menumbuk 
lesi	Kutuk
loghat	Bahasa
lengas	Keluar air lekit daripada batang atau kulit
langsat	Sejenis duku
langsi	Tirai
lengkuas	Sejenis Jahe
mabuk	Hilang ingatan
mata	Mata
majal	Tumpul
macam	Jenis bagi macam-macam
maju	Mara kehadapan
madat	Candu
madam	Perempuan baik-baik
madu	Manisan lebah
madah	Kata
marak	Menyala besar
marah	Panas hati
maruh	Pukul
mari	Panggil
masak	Sudah matang pada buah
masam	Rasa yang menjadikan kerut dimuka
masin	Rasa garam
masih	Ada lagi
mangas	Nama kayu
mangus	Dapat bernafas
mapar	Rata
maki	Kata nista
malang	Celaka
malap	Tiada bernyala
malung	Nama ikan
nadi	Urat yang bergerak
nara	Orang perkasa
nasi	Beras yang dimasak dengan air
nangoi	Ibu babi
napuh	Rusa kecil
nakal	Tiada tahu
naga	Ular yang besar dalam lautan 
nanar	Gila
nanah	Darah yang menjadi busuk
nahak	Hendak sangat
naib	Timbalan
naik	Pergi keatas
najis	Apa-apa benda kotor
nakhoda	Kapten
nazar	Doa yang dipesertakan dengan janji
neraca	Timbangan
nirmala	Kayu atau mala sendiri
nista	Hamun
nazam	Karangan pujian
nikmat	Karunia tuhan
nak	Ringkasan dari kata hendak
noktah	Titik
nikah	Perhubungan yang menjadikan laki bini dengan halal
negara	Negeri bagi bilangan banyak
negeri	Tempat yang besar daripada daerah
nombor	Bilangan
nampak	Kelihatan
nanti	Tunggu
nawab	Naib
notis	Pemberitahuan
nur	Cahaya
nelayan	Kerja menangkap ikan
niat	Maksud dalam hati
nipah	Jenis pokok rumbia yang kecil bertumbuh ditepi laut
nilam	Permata biru
nilai	Taksir harga
ninis	Berair bagi luka
nenek	Bapa atau ibu kepada datuk
niur	Kelapa
nanas	Sejenis buah yang masam dan berduri
nobat	Gendang kerajaan yang dipalu berkenaan dengn istiadat
