a.ba-a.ba 	petunjok berupe perentah (dalam bares-bebares, olah rage, dsb): komandanpasukan memberikan -- bubarkepada anggotanya, 'pemimpin pasokan perintah aba-aba kepade anggotenye
a.bad	jangke waktu seratos taon: dia sudah berusia setengah .
berabad-abad	berabad-abad; beratos-ratos taon lamenye
a.ba.di	kekal; tak sebenta, tak ade akhenye.
mengabadikan	mengekalkan; menjadikan sesuatu hal menjadi kekal.
a.bai 	lalai, 'tak kerje dengan semestinye; menanggoh-nanggoh kerje'
a.bang	saudara laki-laki yang lebih tue;
ab.di	abdi; hambe; orang bawahan yang taat setie kepade atasannye:
ab.nor.mal	hal-hal yang tidak biase; menyimpang dari biase
a.bor.tus	menggugokan kandungan; tegugo" 
ab.sen	tidak hade
ab.solut	kuase yang mutlak (tidak dapat dibantah, ditentang)
ab.strak	sesuatu yang tak nyate; tak ade wujudnye
a.bu	abu; bende yang mudah berubah sifamye menjadi halos, hanco, seperti kayu dibaka hangos menjadi arang,
a.bu-a.bu	wame kelabu: Ia memakai baju -,' die make baju wame kelabu
a.cak	adok, bende-bende yang beserak,
acak-acakan	kacau-balau; bende-bende yang tidak terato: susunan
a.cap	kerap, senng,
acapkali	kerap kali; selalu
a.cap	masuk dalam-dalam: keris itu pun -- lah, 'keris itu pun masuk dalam-dalam'
a.car	aca (sejenis laok penyedap makanan yg dibuat dr buah-buahan dan daon-daon sayo yg diben cuke supaye masam)
a.ca.ra	acare; rencane sesuatu maksud: apa -- malam ini? ape acare malam ini?'
acuan	alat untok membuat sesuatu (micetak kueh, batu bate dsb):
a.cu	cube; -- celana itu dulu, mana tahu tidak cocok! 'cube selua itu dulu, takot nanti takpas
a.cuh 	acoh; mengindahkan; menaroh perhatian:
a.da	ade; hader; telah tersedie:
a.dab	sopan santun; kehalusan dan kebaikan budi pekerti:
a.da.ka.la.nya	ade kalenye; ade masenye;
a.dat	yg lazim diturut dan dilakukan sejak dahulu kale; kebiasaan; aturan
adat-istiadat	bebagai-bagai adat kebiasaan
a.de.gan	bagian kecik dari pade babak dl sandiwara;
a.de.gan n	sejok; tempat yg nyaman (disebabkan olth udare yg sejok);
a.dik	adek; saudare yang lebih mude; panggilan kepade orang yg lebih mude
a.dil	adil; tidak memihak; pade tempatnye:
ad.mi.nis.tra.si	paigurusan surat-menyurat pade suatu jawatan;
a.don	adun (mencampo bahan-bahan untok membuat kuth dng aei
adonan	" adunan (camporan bahan-bahan untok membuat kueh yg
sudah merate"
a.duk	bende yg dicampo kemudian dikacau sthingge rate (sebati);
ad.vo.kat	pengacara (ahli hukum yg bertindak sebagai penasthat hukum)
ae.ro.bik	senam (gerak badan) secara terato di udare terbuke untok menj age kesehatan
a.fa.si.a	gagap atau gangguan becakap-cakap bagi seseorang yang disebabkan oleh gega otak:
a.gak	agak; lebih kurang; kire-kire; siket:
a.gar	supaya: belajarlah dengan rajin -- kelak engkau naik kelas, rbelajarlah dng raj in supaye kelak dikau naek kelas'
a.gen n	agen (wakel usuran pedagangan msl penjualan surat kaba, majalah)
a.gen.da	buku catatan; acare yg akan dibicarekan dalam petemuan; h
a.gi.ta.tor	pengasot; orang yg mempengarohi orang laen untok suatu maksod:
a.gung	agong; mulie; besa: Tuhan Yang Maha--, 'Tuhan Yang Maha agong (mulie)';
a.gus.tus	ogos; bulan kelapan pade taon Masehi.
a.had	ahad; harl petama dl peritongan taon Hijrah;
ah.li	orang-orang yg masok dl suatu golongan; kaom, keluarge; sanak saudare: -- warEs, 'abli wares';
a.ib	aeb; cele; cacat; rase malu; name burok:
a.ir	ae; brang cae yg selalu digunekan untok minom, mandi, membasoh baju(kaen)dsb.
a.ja.ib	ajaeb; kejadian yg ganjel; aneh; tak seperti blase: bayi --, 'budak kecik ganjel';
a.jak 	ajak; suroh ikot; supaye turot: --Iah kawanmu masuk!, 'ajak lah kawanmu masok';
a.jal	ajal; mati; maot; batas waktu idop dan mati: beliau telah sampai -- dng Ienangnya
a.jang	medan; tempat betempo: -- peperangan, 'tempat beperang'
a.jar	 aja; sesuatu yg dikatekan kepade seorang atau banyak orang untok diketahui.
a.jek	tetap; tak berubah; tegoh
a.ka.de.mi.	setengkat maktab; peguruan tinggi yg mengajakan sesuatu pengetahuan (keahlian)
a.kal	akal; daya pike; alat untok bepike; 
a.kan	akan; mengenai; tentang hal; terhadap; untok menyatekan sesuatu yg endak tejadi:
a.kar	 aka; bagian tumbohan yg ade dekat dalam tanab dan begune sebagai penguat dan pengisap zat makanan; a
a.khir	akhe; belakang; kemudian; pgabes; kesudahan; 
a.ki.bat	akibat; peristiwe yg tejadi yg merupekan kelanjotan dari suatu sebab;
akla.ma.si	mengeluakan suare tande setuju dalam rapat secara lisan, tapi tak diitong
a.ko.mo.da.si	tempat untok makan dan tido bile seseorang melakukan pejalanan:
ak.rab	akrab; kareb; dekat dan erat
ak.ro.nim	singkatan kate; umpamenye: Bandes (Bantuan Desa)
ak.sa.ra	urof, lambang-lambang bunyi bahase
ak.sen	tekanan suare, baek pade kate maupon suku kate
ak.sep.ta.bel	diterime dengan baek; dapat diterime
ak.sep.tor	"orang yg mengekot (melaksanakan) program keluarge berencane
"
ak.tif	giat (bekerje maupon berusahe):
ak.ti.vis 	orang yg bekerja giat dalam pekumpolannye:
ak.ti.vi.tas	kegiatan, kesibokkan; melakukan kegiatan:
ak.tor	pelakon laki-laki
ak.tris	pelakon perempuan
ak.tual	sesunggohnye
a.ku	pro saye; kate ganti orang petame:
a.kua.ri.um	bak kace untok mele ikan bias
a.kun.tan	ahli yg kerjenye nyuson dan membimbeng, mengawas, mempebaiki tate buku
a.kun.tan.si	hal yg behubong dng akuntan
a.ku.pung.tur	pengobatan lame Tiongkok dng care mencocok jarom
a.ku.rat	seksame: tehti; cermat: caranya bekerja sangat --, 'carenye kerje sangat teliti'
a.kut	tiba-tiba, mendadak dan memburok; tak diduge (biasanye pade penyaket)
a.lam	dunie; semue yg ade dekat langet dan bumi
a.la.mat	tande; petande; tempat diam seseorang:
a.la.mi	lazem; seperti biase; seuatu yang belom berubah:
a.lang	rintang; lintang; kayu yang melintang di bawah atap rumah:
a.lang	alang-alang; alang kepalang; tanggong: -
a.las	alas; sesuatu bende yang diletakkan di bawab sebadasa:
a.lat	alat; pekakas; bende yg dipakai untok kerje 
al. Bum	albom; tempat nyimpan gamba-gamba:
a.lim	a alem; taat menjalankan perentah ugame
a.lir	ale; meleleh; begerak maju (diperuntokkan pd bende cae):
al.ko.hol	n alkohol; beide cae yg mabok
Allah	Tuhan; pencipte alam semeste beserte segale isi yg ade di dlnye:
al.mar.hum 	mendiang; orang yg sudah meninggal dunie
aI.qur.an	qoran; kitab suci umat Islam
al.ter.na .tif	pilehan; memileh salah satu hal
a.mal 	amal bebuat baek untok dapat pahale;
a.ma.nat	amanat; pesan; sesuatu yg disampaikan kpd orang lain
a.mat	sangat; paleig; telampau; telalu
a.ma.tir	amatir; orang yg mengerjekan suatu hal secare sambelan aje
am.bi.gu	ambigu; sesuatu hal yg punye erti due; erti gande
am.bil	ambek, kecik: --lah kitab ini
am.bi.si	asrat; nafsu ingin dapat sesuatu
a.mis	anyi; ames; bau spt ikan, darah, dsb.
am.plop	sampol surat
am.puh	ampoh; kuat; manjo; mujarab (obat)
am.pun	ampon; maaf
a.muk	amok; pebuatan yg tejadi kareie marah yg amat sangat sehingge tejadi tindakan babi bute;
a.mu.ni.si 	 bahan peledak spt peluru, bom, dsb,
a.na.fo.ra	penunjukan semule kpd anak kalimat atau kalimat yg mendahului kate ganti atau kate tambahan yang sbg acuannye
a.nai-a.nai 	rayap (semot yg bewame puteh)
a.nak	budak; orang yg kecik badan dan umonye
a.na.li.sis	mengkaji suatu peristiwe untok ambek tahu ape sebab musababnye
a.nalo.gi	"menurot hernat; pesamean atau disesuaikan antare due bende
yg bebede di- contoh yg ade:"
an.cam	ancam; gugat;
an.cang-an.cang	ancang-ancang; kude-kude: pelan itu memasang --, pelari itu memasang kude-kude'
an.car-an.car	agak-agak; kire-kire:
an.dap	pron dikau; kau; kate ganti diri orang kedue:
an.dai	misal; umpame: —kan dia masih hidup,
an.dal	andal; lihai; hebat; gagah pekase:
a.neh	ajaeb; ganjel; laen dr yg laen
a.ne.mi.a	 kurang darah (saket kurang darah)
a.nes.te.si	seba; tak ade rase ape-ape
a.ngan	angan-angan; melamon; cite-cite; khayalan; bike yg bukan- bukan
ang.gap	anggap; mandang sebagai; pendapat;
ang-guk	anggok, tande setuju
ang.gun	anggon, keibuan (tentang perangai, bepakaian, dsb)
ang.gur	anggor; name buah: buah --, 'buah anggor'
an.gur, menganggur	nganggor tak ade kerje:
a.ngin	angen; hawe, udare: hembusan --, 'embosan angen'
ang.ka	angke, nilai, ponten: ujiannya mendapat -- tujuh, 'ujiannye dapat ponten tujoh'
ang.kat	angkat; membawak ke atas
ang.ker	bepuake, bebahaye; berantu; tempat orang alos:
ang.sur	anso; siket-siket; berisot
a.ni-a.ni	pisau untok ngerat padi
a.ni.a.ya	nyaye; bebuat yg nyekse:
a.ni.mo	asrat; cite-cite; maksod; tujuan; keinginan:
an.jak	anjak. ensot; pindah tempat:
an.jang.sa.na	kunjongan; menjengok sanak saudare,
an.jung	anjong; bagian rumah spt bilek yg lantarnye lebeh tinggi dr lantai rumah
an.jur	menganjur vt anjo; menganjo; menjorok ke depan:
an.tar	anta; bawak ke
an.ta.ra	antare; jarak yg teletak di selah-selah due bende:
an.ta.rik.sa	angkase; ruang angkase; angkase lua
an.ta.nk.sa.wan	orang yg megang kamudi kapal angkase lua
an.tek	mate-mate; tukang pokol; kaki tangan; abdi
an.te.na	antena (pd televisi atau radio); -- televisi, 'antena televisi'
an.ti	melawan; nentang; tak setuju; musoh: undang-undang -- korupsi, 'undang-undang melawan makan suap';
antibodi	antibodi; zat untok melawan saket;
antibiotik	zat untok munoh kuman penyaket spt panasilen
an.tu.si.as	besemangat; gairah; beminat: dia begitu -- untuk menjadi ketua,
a.nu.ge.rah	hadiah; karunie:
a.nu.mer.ta	anumerta; gela yg diberi sesudah orangnye meninggal
a.nut	anot; nganot
a.nyam	anyam; -- tika itu
a.pa.bi.la	bile; jike; waktu (sewaktu);
a.pa.la.gi	apelagi; lebeh-lebeh lagi: tambah pulak:
a.pa .tis	peduli; ah, pedulikan
a.pel	upacare; bekumpol untok dengarkan amanat; pesan; keterangan
ap.li.ka.si	"tambahan: untuk menambah ilmu, kita harus mengikuti
kursus "
ap.re.si.a.si	nilai; sada akan nilai-nilai:
ap.ril	aprel; name bulan yg nomor empat pd taon Masehi
ap.ri.o.ri	sebelom tau (nengok, nyelidek) keadaan yg sebenanye:
a.pung	tak tengelam di ae; apong; timbol;
a.rah	tujuan; maksod; asrat
ar.ca	patong (tebuat dr batu dan dibuat orang dulu)
a.re.na	gelanggang; panggong; pentas
ar.go.me.ter	alat penunjok jumlah duet (dl kereta atau teksi):
ar.gu.men	alasan; landasan pendapat; bukti-bukti
ar.gu.men.ta.si	pemberian alasan
a.rif	adel; bijaksane; tau
a.ri.san	aresan; nabong duet olah beberape orang, lalu diundi sesamenye
ar.ka.is	antek; kuno; lame; tinggal zaman
ar.sip	petinggal; yg ditinggal (sekarang surat-surat):
ar.ti	erti; makne; maksod; gune; faedah
ar.ti.kel	tulesan; karangan (dl surat kaba atau majalah):
a.rung	arong; berjalan di ae
a.rus	aros; aleran; gerak ae yg ngale:
a.sah	asah; gosok (untok najamkan pisau; ngasok intan, dsb):
a.sal 	asal; tempat yg jadi pangkal sesuatu
asal-usul	asal mule; asal muasal; keturonan
a.sam	masam
a.sap	asap; kabot yg kelua dr sesuatu yg tebaka;
a.sas	dasa; tumpu bepike; ukom dasa
a.sa.si	asasi; yg jadi dasa; yg pokok; hak-hak dasa:
as.bes	asbes, serat yg tak mudah jadi abu kalau tebaka (tahan panas)
a.si.mi.la.si n	proses ngolah zat pd tumbohan yg ade bute ijau dng cahaye mateari;
a.so.si.a.si	pekumpolan dng kawan sejawat (sekeije): behubongan antare satu dng yg laen
as.pek	tande; segi; sudot pandang:
as.pi.ra.si	arapan; tujuan; cite-cite; maksod
as.tro.nout	astronot; pengemudi kapal ruang angkase
as.tro.no.mi	ilmu yg mempelajari materi bulan, bintang, dan planet: elmu falak:
a.suh	jage(merawat dan mendidek) budak kecil:
a.sum.si	anggapan, dugean; pikeran; pendapat;
a.su.ran.si n	janji antare due pihak, pihak yg satu wajeb maya yuran dan pehak yg lain wajeb meri jamenan kpd pembaya yuran bile tejadi melepetake yg nimpe dirinye; duet jamenan; duet tanggongan:
a.syik	asik; suke; sedap:
a.tap	atap; panutop rumah
a.ta.se	ahli pade kedutean untok nguros sesuatu
a.tau	atau, penyatean untok mileh di antare due: surat kabar -- majalah'
a.ta.vis.me	sifat yg lame muncol lagi
a.te.is	ateis; tak pecaye adanye Tuhan:
atlet	atelet; orang yg berolah raga (perlu tenage yg kuat):
a.tom	atom; unso kimia yg paleng kecik, dpt bediri sendiri dan dpt senyawe dng yg lain:
at.ri.but	ateribot; tande kelengkapan, lambang:
a.tur	ato; suson; terteb; rapi
au.di.en.si	kunjongan kehormatan: - Presiden, 'kunjongan kehormatan Presiden'
au.di.o	berkenaan dengan pendengaran
au.di.o.vi.su.al n	alat pandang dengan spt televisi, film, dsb
au.la	balai rong; ruang besa (untok rapat; ade acare):
au.rat	batas badan yg tak boleh tengok (secare Islam); aorat:
a.us	aos; susot kerane kene gosok selalu (kite pakai selalu):
au.to.bi.o.gra.fi	otobiografi; riwayat idop diri sendiri yg ditules sendiri; cerite tentang diri sendiri:
au.top.si	pemerekseen mayat;
a.wak	awak; dikau; saudare; badan; anak buah
a.wal	awal; mule (mule-mule); petame
a.wam	awam; umom; biase:
a.was	awas; terang; masih dpt nengok dng baek:
a.wet	awet; tahan lame; tak lekas rosak; spt orang mude:
a.yak	ayak; tapes; pengayak:
a.yal	lambat; lemban; ligah; lalai; lame:
a.yat	ayat; bares; nyawe:
a.yom	lindong; tedoh:
a.yu	lawa; molek; elok
a.zab	azab; sekse; ukoman
a.zan	bang
bab	bahagian dan keselurohan undang-undang:
ba.bad	karye sastre sejarah:
ba.bat	bebat v melekapkan kaen, tall, atau lainnye kepade sesuatu digan dibelitkan:
ba.bi 	babi n (sejenis binatang bermulot panjang, berkuku ganjil, yang diharamkan oleh agama Islam untok memakannye):
ba.ca	membace (untok orang, melakukan pekerjaan):
bacaan	kitab (yang dibace) —pantun dan syair, 'kitab panton dan syair';
ba.cok	tetak (tikam, dsb) mis. sekali -- ta pun jatuhlah, 'sekali tetak ia pon jatohlah';
ba.dai	badai  (angin kicang yang datang tibe-tibe; topan):
ba.dak	badak (binatang menyusui yang berkulit tebal dan bercule):
ba.dan	tubuh (dalam arti jasad manusia): -
ba.dik	badik (sebangse senjate tajam bermate satu):
ba.gai	macam: bunga tujuh -- ; 'bunge tujoh macam';
ba.gai.ma.na	bagaimane (sesuatu yang berhubongan dengan keadaan, menyatakan din, dsb). mis. --- cara kita menyatakan hal itu;
ba.gan	bagan (tiang-tiang kayu yang digunakan untuk menjemur ikan):
ba.gi	bagi, untok, buat: pakaian yang sebuah itu -- ayahlah
ba.gus	elok (rupa) balk sekali:
ba.ha.gia	bahagie
ba.han	bahan (barang yang akan dipakai untok suatu keperluan)
ba.has	teroka (melakukan pekerjaan uji):
ba.ha.sa	bahase (kadang diucapkan bahse) alat ucap (tataran bunyi) yang dihasilkan oleh manusie, dipakai suatu bangse:
berbahasa	berbahase, bertutur:
bahasawan	bahasewan (orang yang menguasai soal-soal bahase:
bah.kan	bahkan (menyatekan melebihi atau menekankan pade sesuatu):
ba.hu	bahu, pundak (antara lehe deigan pangkal lengan)
bah.wa	bahawe (menyatekan hal yang sesunggohnye):
ba.ik	baek (menyatekan keadean sesuatu, orang): 
ba.it	baet (bahagian dan puisi, terdiri atas dua baris, dan tak tentu untok puisi modem sekarang)
bai.tul.lah	baitullah, rumah Allah (masjid,surau, mushala)
bai.tul. mal	baitulmal, perbendaharean
baja	baje besi yang amat keras;
ba.jak	bajak alat untok menggemburkan tanah (dipakai oleh penati);
ba.jan	kuah besi yang besa, biase dipakai untok memasak wajit atau gelamai; wajan
ba.jang	polong, jembalang a (makhluk halus, hantu, dsb).
ba.jik	baek (untok perbuatan);
ba.jing	"bajing tupai (bangse binatang pigerat); 
"
bajingan	bajingan, penjahat (untok orang; biasejuga untok memaki seseorang):
ba.ju	baju (pakaian untok menutup tubuh):
ba.kal	baka; bahan untok dibaka (spt. minyak, kayu, dsb).
ba.kat	bakat; bekas; kesan; tande-tande (luke):
ba.ki	baki dulang kecik (sebangse talam atau tadah)
bak.ti	bakti pernyataan tundok, setia, mengabdi dan taat:
ba.ku	aku,saling(pertentangan,bertingkah): 
ba.la.da	balade (karangan pusisi yang berbentuk romantis dan berupe nyanyian)
ba.lai	pekan, pasa: anak itu pergi ke --, 'budak tu pergi ke pekan (pasa), 2 tempat pertemuan; balai:
balai-balai	ambin (tempat duduk);
balai budaya	tempat pertemuan untok membicarekan perihal budaye;
ba.lai.rung	balairung; tempat atau ruang menghadap raje:
ba.lap	pacu (untok kendaraan, seperti sepeda, motor, mobil dsb):
ba.las	balas, j awab: --lah kalau kau berani;
balut	bebat; barut (kain dsb): kain --, 'kain bebat';
bam.bu	buluh; aur (nama tumbuh-tumbuhan yang berakar serabut):
ban.dar	parit ae (saluran air limbah dsb);
ban.ding	banding; tare; imbangan; persamean:
ba.ngau	bangau nama burung yang kaki dan lehenye panjang (burung in banyak mamye):
bang.ga	bangge; bangge hati (perasaan dsb):
bang.kai	tubuh atau jasad yang tak bernyawe lagi; bangkai
bang.kang	membanai, mentang:
bang.krut	mengalami kerugian besa; bangkerap; habis modal:
bang.ku	ambin tempat dudok (terbuat darl kayu dsb)
bang.sa	orang-orang yang same asal atau keturunannye; bangse:
bang.sal	rumah atau ruang besa (bise untok kandang, bise juge untok gudang; bangsal)
bang.sa.wan	abatan gelaran yang diberi raje kepade orang-orang dalam hngkungan istane; bangsewan,
ba.ngun	bangun ---- bangkit;
ban.jir	banjer (keadean yang melebihi dari biasenye:
ban.tah	sangkal;
ban.tai	sembelih;
ban.tal	bantal; alas kepale yang dibuat dari kain isinye kapuk:
ban.ting	banting: menghempaskan sesuatu (hal, dsb): -
ban.tu	memberikan suatu pertolongan, dsb; tolong;
ba.nyak	banyak; tak sedikit (jumlah dsb)
ba.pak	orang tue laki-laki (biase juge orang yang dituekan; guru, dsb; abah, ayah)
bara	 arang yang masih menyale (pembakaran); bare: 
ba.rang	barang, bende (yang umum):
ba.rang.ka.li	agaknye (agak-e/a); belum tentu bena:
barat	barat; arah matahari tenggelam
ba.ring	tidur (berehat, dsb);
ba.ris	baris jajar (menyatekan letak, dsb):
ba.ru	baru ' yang sebelumnye tidak ade; belum pemah dilihat (sesuatu hal, dsb):
ba.rut	urut (mengoleskan pada badan):
ba.sa-ba.si	berbasa-basi; hanya sekeda menawakan (hal cara, dsb):
ba.sah	basah terkene aei (terserap bende cae):
ba.si	rusak dan busuk karene lame disimpan, (tentang makanan dsb) basi:
ba.suh	membersihkan sesuatu (hal, care dsb): basuh:
ba.tang	batang pokok; pohon (tnang kayu, dsb):
ba.tas	sempadan, perhinggaan suatu bidang (ruang, daerah, dsb): 
ba.lik	batik; gamba pade kain (ade yang dibuat dengan tangan, ade yang dengan cetakan; alat die disebut canting;
ba.tin	batin 1 pangkat dalam masyarakat, yang dianugerahkan kepada seseorang:
ba.tu	batu benda keras yang asalnya daii bumi, tetapi bukan logam:
ba.tuk	batuk; sejenis penyakit pada pemapasan:
ba.u	bau, yang dirase oleh hidung (penciuman):
ba.ur	baur; campu (penggabungan dua unsur)
ba.wa	membawe; mengangkut (memindahkan sesuatu dari satu tempat ke tempat laen):
ba.wah	bawah; arah (letak) lebih rendah (lawan atas):
ba.wang	bawang; nama tumbuhan yang umbinya dipakai untok membuat masakan, berwama putih atau merah
ba.yam	bayam; nama sejenis tumbuhan yang digunakan untok sayur (terkadang huruf (r) tidak terdenga)
ba.yang	bayang; bias, ujud kehitaman yang tampak di balik yang kena sina (cahaye);
ba.yar	baya (bunyi ucapan (r) tak terdengar) memberikan sesuatu (sebagai alat tuka) untuk barang yang telah dibeli:
ba.yi	ayi; budak baru lahe (anak yang dilahirkan oleh manusia yang masih berusia beberapa hari)
ba.zar	bazar, pasar, tempat keramaian (biasenye merujuk pade tempat orang berjualan keperluan sandang pangan)
be.a	pajak, cukai, biaye, ongkos: - masuk, 'bea masok'
be.bal	bebal, bodoh, tiade berpengatahuan, lemah die daripade maigambil dalil keadaan ilmu;
be.ban	beban; muatan; tanggungan (berupa barang, bende, yang ditaruhkan pade pundak, dsb): 
be.bas	bebas; lapas same sekali; tanpe beban (tak terhalang, terganggu, dsb):
be.bat	babat
be.ber	beber; urai (menjelaskan dengan nnci, membentangkan, hal dsb)
be.be.ra.pa	beberape, untuk menyatekan Mangan yang kurang tentu (banyaknye atau sedikitnye):
be.cek	lecah; berair dan berlumpur 
be.da	bede; sesuatu yang menjadikan berlaman (tidak same) antare due benda (hal, care, dsb):
be.dak	bedak, sebangse tepung yang harum baunye, dipakai untok membarut muke, dsb,
be.dil	bedil, alat tembak yang Ietusannya berbunyi (senjate api, dsb);
be.gi.ni	begini; seperti ini; demikian ini:
be.gi.tu	begitu; seperti itu; demikian itu:
be.ha	beha; kutang; kain yang dibuat khusus untok peimtup payudare (untuk perempuan; wanita)
be.ja.na	bejane; tempat menyimpan ae; kuali besa untok tempat memasak gelamai
be.jat	bejat, nakal sangat, berkelakuan buruk (tentang pekerti): anak -- 'budak bejat';
be.kal	"bekal; sesuatu yang hendak dibawe dalam perjalanan (makanan,
duit, dsb):"
be.kas	bekas; sisa yang ditinggalkan (bise berupe tande, dsb):
be.ku	beku; mengental; lawan encer (untok care berpikie seseorang), tak hendak lagi ditunjuki yang benar;
be.kuk	bekuk, melengkungkan barang yang kaku (rotan, kawat, dsb):
be.la	bele; menolong, pelihara (menjade dengan baek); melindungi dan sesuatu'
be.lah	belah, membuat menjadi lebih dari satu bahagian;
be.lai 	belai; usap; rabe (ungkapan rase kasih sayang, hal, care dsb):
be.la.kang	belakang; lawan depan (arah, letak sesuatu, hal, dsb): -- rumah; 'belakang rumah',
be.Ia.lai 	belalai; hidung gajah yang panjang
be.la.lak 	belalak; belalang; melotot; membuke mate leba-leba:
be.la.lang	belalang
be.lan.ja	belanje; biaye yang dipakai untok sesuatu; uang yang dipakai untok keperluan rumah tangge;
be.la.sung.ka.wa	belasungkawa; berduka cita:
be.la.ti	belati; pisau kecil yang tajam matanye
be.leng.gu	belenggu; alat pengikat (berupa rantai, besi atau kayu) yang dipasangkan di kaki atau di tangan;
be.li	beli; lawan jual; memesan sesuatu yang akan dibaya kemudian:
be.li.au	beliau; ia, die (sebagai kata ganti orang kedue tunggal; diuntokkan bagi orang tue atau yang dihormati):
be.lim.bing	belimbing; nama pohon dan buanye
be.lit	belit; lilit; pusa, puta:
belok 	belok; kelok; keluk (arah, dsb):
be.Iu.kar	beluka; semak yang ditumbuhi kayu-kayu kecil:
be.lum	belum; lawan sudah; masih tetap (hal, dsb):
be.nah	benah; baiki; kemas (mengatou sesuatu sehingge terlihat cantek, asri dan indah): tempat tidurmu, 'benahi tempat tidou kau';
be.nak	benak; otak (kate orang maknenye kasa)
be.na.lu	"benalu nama tumbuhan yang hidopnye melekat pade tumbuhan
laen"
be.nam	benam; letak sesuatu (menyatekan tempat; kate ini jarang dipakai dalam bentuk dasarnye):
be.nar	bena (dalam ucapan sehari-hari, sering hanya terdengar diucapkan na); betul; lawan salah:
be.nang	benang; yang terbuat dari serat daun nias; atau dibuat dan kapas (dipakai untuk menjahit atau membuat kain)
ben.ca.na	bencane-petake; musibah: 
ben.ci	benci; sangat tak disukai (sifat, hal, cara, dsb); rase tak senang
ben.da	bende, sejenis barang; segale yang berwujud dan berjasad (bukan nih):
ben.de.ra	bendera; kain yang dipakai sebagai lambang sesuatu; bise juge sebagai panji-panji; umbul-umbul:
ben.de.rang	benderang; terang sangat (tentang cahaye):
ben.dung	bendung; tahan; halang; empang;
be.ngis	bengis; kejam; lalim tak menaruh belas kasih:
beng.kak	bengkak; menjadi besa karene sesuatu (penyakit, dll):
beng.ka.lai	terlantar; belum selesai dikerjekan, tetapi telah ditinggalkan (tentang pekerjaan, urusan, dsb )
beng.kok	bengkok; sesuatu yang tidak lurus (kayu, hal dsb):
be.nih	benih, bibit, tamp ang, sesuatu yang akan ditanam: 
be.ning	bening,jernih, bersih (hal jiwe):
ben.tak	bentak; hardik; teking:j
ben.tang	bentang, hampar, membuka sesuaatu (seperti tikar, dsb):
ben.tuk	bentuk; rupe; berupe; menyerupa
ben.tur	bentur; berbenturan; sesuatu yang beradu; bertumbokan:
be.ra.hi	berahikan; perasaan cinte kasth (rase sayang dsb):
be.rak	berak; kotoran (tinja): 
be.ran.da	berande; serambi; teras (untok rumah);
be.ran.dal	degil; suke mengganggu kesenangan orang laen; pengacau (tingkah laku)
be.rang	berang; marah; menjadi marah sangat; temberang: 
be.ra.ngus	berangus; keadaan marah yang tidak dapat dikendalikannye lagi
be.ra.ni	berani; bagak; sifat batin yang tak takut menghadapi bahaye (kesulitan, dsb). tak penakut:
be.ran.ta.kan	berantakan; tak teratur; kacau balau; berserakan (hal, care, dsb):
ca.bai	lade; pokok yg buahnye bebentok bulat panjang dng ujong ronceng, bile tue bewame merah, rasenye pedas (name tumbohan):
ca.bang	dahan; bagian yg tumboh pd pokok kayu (biasenye betipang due):
ca.bik	koyak; rabak; robek: bajunya -- di bagian punggung, 'baju die koyak dekat punggong;
ca.bul	cabol; becakap yg tak senonoh:
ca.but	cabot; menarek sesuatu bende supaye lepas, ngambek sesuatu (spt undian):
ca.cah ji.wa	cacah jiwe; picatetan untok ngambek tau jumlah pendudok:
ca.car	caca; penyakit kulet yg disebabkan virus:
ca.cat	cacat; kurang sempurne; tak lengkap:
ca.ci	caci; cele, cerce; becakap yg tak baek untok orang lain
ca.ci maki	caci maki; hine dine; sumpah serapah:
ca.dar	cada; kain penutup kepale (muke) untok orang perempuan:
ca.gar	caga; pesediean; daerah yg kene lindong pemerintah:
ca.ha.ya	cahaye; 
ca.ir	cae; lembek; tak keras;
ca.kap	sanggop; mampu; dapat; pandai;
ca.kar	caka, tekene gores bende tajam
cak.ra.wa.la	batas pandang spt bike:
ca.kup	cakop; isi;
ca.lo	cab; orang yg jadi perantare dan meriksajasye bedasakan upah
ca.lon	calon; bakal: - menantu, 'bakal menantu'
ca.mar	cama; name burong laot
cam.bang	rambot yg tumboh dekat pelipes ke pipi teros ke dagu cambang:
cam.buk	cambok; alat yg bulat panjang dan lento untok mukol:
cam.pak	campak; buang; lempa:
cam.pur	campo; adok; kacau; menjadi satu
can.da	cande; gurau-side; seloroh; tak betol-betol;
can.di	candi: 'Candi Borobudur'
can.du	candu; getah yg kuning yg kelua dr temakau:
cang.gih	canggih; maju; moder: 'zaman canggih'
cang.gung	canggong; kaku: cara berjalannya --,'care bejalan die kaku
cang.kir	cangke; cawan: Se-- kopi, 'secawan kopi'
cang.kok	cangkok; membuat dahan jadi beraka:
cang.kul	cangkol: bapak mengambil --, 'bapak ngambek cangkok';
can.tik	cantek; lawa; moleh; elok; bagus:
can.tum	cantom; lekat; sambong;
ca.pai	nyapai; nggapai: 
cap.lok	caplok; tangkap;
ca.ra	care; jalan; atoran; gaye atau ragam:
ca.ri	carik; nemukan sesuatu yg ilang;
ca.rik	robek; koyak; elai; layang:
car.ter	nyatar; nyewe: ia sebuah taksi
ca.tat	catat; catet; tules:
ca.tur	cator:
ca.tut	catot, angkop; penyepet; alat untok nyabot sesuatu:
ca.wan	cawan; cangke
ce.bol	cebol; pendek; param;
ce.bur	cebo;jatoh ke ae spt kolam;
ce.cer	ilang tak tau tentunye;
ce.de.ra	cedere; cacat; luke; celake:
ce.gah	cegah., tegah:
ce.gat	nyegat; ngadang; n jage di jalan
ce.kam	cekam; cengkam:
ce.ka.tan 	pinta; pandai; tangkas; cerdek; maher:
ce.cok	 betengka; ribot; kelai; sebok:
ce.kik 	memegang lehe hingge tak dapat benapas, nyekek:
ce.kok	cekok, obat yg dibuat dr rempah yg dimasokkan ke mulot dng pakse,
ce.kung 	cekong; kuyu; belekok
ce.la	cele, tak sempurne, cedera; cacat; ine; dine:
ce.la.ka	 celake, naas, malang; sial, tak beruntong:
ce.la.na 	celane; selua: -- panjang, 'selua panjang'
ce.Iup	celop, masokkan ke ae
ce.mar	cema; busuk; koto; keji; node:
ce.mas	cemas, khawate; takot, resah; gelisah:
cem.be.rut	cemberot; masam:
cem.bu.ru	cemburu; iri ati:
ce.mer.lang	cemerlang, bekilau; bekilat; begelige (cerdas):
ce.mo.oh	cembeh; cemooh; ejek; hine:
cem.pa.ka	cempaka, pokok yg bungenye wangi, bewame puteh dan kekunengan:
cen.da.na	cendane, tumbohan yg kayunye wangi:
cen.da.wan	senawan: spt -- dibasuh, 'spt senawan dibasoh'
cen.de.kia	cendekie; tajam pikeran ;cerdas, pandai, pinta, tepelaja:
cen.de.ki.a.wan	cendekiawan; orang yg pinta; orang yg cerdek pandai
cen.de .rung	cenderong, condong, mereng:
ce.gang	cengang; tepegon; tetegon:
ceng.kam	cengkam cekam:
ceng.ke .ram	cengkam, cekam;
ceng.ke.ra.ma	sende gurau
ce.pat	cepat; lekas; deras; laju; segera:
ce.rah	cerah; terang; beseri:
ce.rai	pisah; talak:
ce.ra.mah	ceramah; pidato:
cer.das	cerdas; cerdek; pinta pandai; panjang akal; licik:
cer.dik	cerdek; cerdas; pandai; pintai; licik:
ce.ri.ta	cerite; kesah; bohong; akal tipu:
cer.mat	cermat; teliti; hemat; seksame:
cer.min	cermen; kace:
cer.na	cerna, anco;
ce.tak	ce.tak
ce.tus	tos; bunyi besi (mances) yg digores,
cin.ta	cinte; kasih; sayang; tepikat; rindu:
ci.ri	tande:
cip.ta	cipte; buat;
cit.ra	citra; rupe; gamba
ci.um	ciom;
co.ba	cobe; terai; 
co.cok	tusok: -- sanggul, 'tusok sanggol';
co.leng	curik dng kekerasan;
coiok	cocok; tusok:
con.dong	condong; mereng; berat sebelah cenderong
cong.kak	congkak; sombong, bangge, angkoh
con.teng	contig; coreng; coret; palet
con.toh	contoh; tauladan:
co.pet	orang yg mencurik dng tangkas:
da.cin	daceng, timbang; alat untok nimbang:
da.da	dade;
da.dak	tibe-tibe, aleh-aleh; tak diduge;
da.dar	dada, kue yg Mat panjang, tipes dan berinti:
da.e.rah	daerah; tempat; hngkongan:
daf.tar	dafta.  nama barang yg akan dibeli
da.gang 	dagang; niage, kedai, toko, jual,
da.ging	dageng; isi:
da.gu	bagian muke di bawah mulot
da.hak	dahak; ingos; seme:
da.han	dahan; ranteng:
da.hi	muke bagian atas; dai; keneng; muke:
dah.syat	dah.syat
da.hu.lu	dulu; lame; kemaren; awal; petame; mule-mule:
da.ki	daki; panjat; naek:
dak.wa	 dakwa; tuntot; adu; kaba:
dak.wah	dakwah; ceramah; pidato: kotbah;
da.lam	dalam; jaoh ke bawah: sumur itu --, 'perigi itu dalam';
da.lang	pelaku; yg bebuat; orang yg makan wayang:
da.lih	daleh; alasan; dibuat-buat:
daiil	ayat; ukom, dalel:
da.mai	aman; baek-baek aje:
dam.ba	dambe; ingai; rindu; mau; endak;
dam.pak	pengaroh; dampak; langgaran:
dam.par	tedampa; tesanda anyot ke pantai:
dam.prat 	caci; caci maid; hine dine; sumpah serapah;
dan	dan; pula; juge; 
da.na	derme; dane; duet untok:
da.nau	danau; tasek; telage:
dan.dan	solek; dandan; rias;
da.ngau	gubok; pondok:
dang.kal	dangkal; tak dalam; tingga:
da.pat	mampu sanggop; boleh:
da.pur	dapo, tempat masak:
da.ra	gades; dare; are; perawan; 
da.rah	darah:
da.rat	darat; kebon:
da.ri	dari: dan mana, 'dan mane'
da.ri.pa.da	danpade:
dar.ma.wi.sa.ta	piknik; besia, kunjongan; tamasa;
da.ru.rat	gawat; genteng; cemas, semaken parah:
da.sar	dasa; alas:
da.si	dasi; nektai: 
da.ta	bukti; date; nyate:
da.tang	datang; sampai kemari:
da.tar	data; rate; tak tinggi-rendah:
da.un	daon; kartu: 
da.ur	taon,mase
da.wai 	dawai; kawat: 
da.ya	daye; tenage:
e.bo.nit	ebonit, getah vulkanisir yg keras tebuat dr camporan getah dan belerang:
e.dar	eda; puta; mulai belaku:
e.di.si	edisi; keluaran:
e.dit	sunting; edit
e.di.tor	pengedit; penyunting; editor
e.di.to.ri.aI	mengenai atau berhubongan dng editor
e.du.ka.si	pendidikkan: pendidikan seumur hidup,
e.du.ka.tif	besifat mendidek:
e.fek	akibat; pengaroh:
e.fek.tif	berasel; begune; bemanfaat; tepat:
e.fi.si.en	tepat waktu, tenage, dan biaye:
e.fi.si.en.si	care yg tepat; kemampuan;
e.go.is	mementengkan diri sendiri; egois:
e.go.is.me	paham egois; paham yg mementengkan diri sendiri:
e.ja	membace satu-satu:
e.ja.wan.tah	ujod; tindakan:
e.jek	ejek; olok/ sinde
e.ko.lo.gi	elmu yg mempelajari ubongan timbal balek antare makhlok idop dng alam sekitanya;
e.ko.no.mi	elmu tentang asas pengaselan, pemagian, pemakaian barang;
e.kor	eko:
ek.sak.ta	elmu yg dapat dibuktikan dng pati spt fisika, biologi, matematika:
ek.se.ku.si	pelaksanean putosan akem;
eks.se.ku.tif	eksekutif; pengelolean; pemerentahan; pengurosan:
ek.sem.plar	 lemba; elai; layang; buah:
ek.sen.terik	aneh; ganjel; ajaeb; tak waja:
ek.ses	sesuatu peristiwa yg melampau batas:
ek.shibi.si	tontonan; pameran; petunjokan:
ek.sis.ten.si	keberadean; adenye:
ek.span.si	peluasan daerah:
ek.span.si.o.nis	condong untok meluaskan daerahnye dng merang dan naklokkan negare Men
ek.spe.di.si	pengireman surat, barang, dsb
eks.pe.rimen	pecobean; peneraian; pengujian:
eks.pli.sit	tegas; terus terang; jelas; tak bebelet-belet:
eks.plo.i.ta.si	pengusahean:
eks.plo.ra.si	penyelidekkan; menyelajah:
eks.plo.si	ledakkan; letosan:
eks.po.nen	pangkat; aka; tokoh:
eks.plo.sif	mudah meledak; dapat meletos:
eks.por	pengireman barang dagang (jual) kelua negeri:
eks.po.si.si	petunjok; pedoman; pameran:
eks.pres	cepat; lekas; laju; ekspres:
eks.pre.si	ae muke; raop muke
eks.tra	tambahan;
eks.strak	saripati; inti
eks.trem	yg paling ujong; paleng tinggi; paleng keras:
eks.tre.mis	orang yg melampau batas
eks.trin.sik	unso lua; yg berasal dr lua:
e.ku.a.tor	gares hayal yg merupekan lewang besa ngelileng bumi;
e.ku.iva.len	serege; same; senilai; sepadam
e.lak	elak; mda;
fa.e.dah 	gune; manfaat
fa.jar	paja:
fa.kir, kefakiran	pake (kakeran); kemiskinan:
fak.ta	nyate; jelas; nampak:
fak.tor	hal yg ikot mempengaruh
fak.tur	daftar nama barang (rege, jumlah):
fa.kul.tas	bagian peguruan tinggi tempat mempelajan suatu elmu:
fa.kul.ta.tif	tak wajeb (tt pelarajaran, dsb), besifat milih salah satu elmu yg kite suke
fal.sa.fah	pegangan idop pandangan idop:
fa.mi.li	kaom keluarge; kaom kerabat; sanak sedare; sedare
fa.mi.li.er	bersifat kékeluargean. akrab:
fa.na	tak kekal; sementare; sekejab:
fa.na.tik	fanatek; sangatyak; sangat pecaye; keyakian; kepecayean:
fa.na.tis.me	keyakinan(kepecayean)yg telalu kuat hingge jadi nyimpang dan tak gunekan akal budi
fanta.si	angan-angan; hayalan;
far.du	pardu; wajeb (aros dilakukan)
far.ma.si	care dan teknologi muat obat; nyimpankannye, nyidiekannye, dan nyalokan (ngedakan)
fa.se	tahap: --demi--, tahap demi tahap'
fa.sih	faseh; berseh dan baek lafalnye (ucapannye):
fa.sik	tak  mempedulikan perintah Tuhan;jahat;buruk; sesat:
fa.si.li.tas	pelengkapan;alat-alat
fa.tal	penteng; mematikan; tak dapat diubah lagi;
fa.ta.mor.ga.na	gejale yg tampak spt genangan ae di waktu panas
fat.wa	petue; pesan; nasehat; pelajaran:
fa.u.na	dunie (alam) binatang
fa.vo.rit	yg sangat disuke, dikagomi; kesenangan; kesukean; kegemaran; kesayangan:
feb.ru.a.ri	pebuari (bulan kedue taon Masehi):
fe.de.ral	a besifat federasi (terutame tentang tate negare, serikat kerje, pekompolan-pekompolan, dsb.
fe.de.ra.si	pekumpolan; kelompok (saling kerje same dan nyatu):
fe.mi.nin	besifat kewanitaan (keibuan)
fe.no.me.na	gejale, tande; keistimewean:
fe.no.me.na	gejale, tande; keistimewean:
fe.o.dal	care pemilekan tanah pd abad petigahan di Eropa; susonan masyarakat yg dikuasai kaom bangsawan
fe.ri	kapal tambang (untok di laot, sungai, selat)
fer.li.li.tas	pembuatan; pengambilan; pemupokkan; pembajean
fes.tLval	pesta rakyat; perayean:
fi.at 	pesetujuan penuh dan restu (resmi):
fi.bar	 bahan kertas yg belapes dan dipadatkan spt pelastek:
fid.yah	dende yg wajeb dibaya (penganti puase atau sholat yg ditinggalkan):
fi.gur	bentok; ujod; tokoh:
fi.gur.an	pelakon penampeng, pelengkap:
fiksi	cerita rekean; rekean; hayalan; tak nyate:
fik.tif	besifat rekean:
flian.tro.pi	cinte kaseh; kasih sayang (kpd sesame)
fi.la.te.li	pgumpolan perangko
fi.Ii.al	cabang; anak perusahaan
film	pilem; gama idop:
fil.sa .fat	elmu yg berisikan akal budi, keindahan perangai
fll.ter	sarengan; tapesan:
fl.nal	tahap teakhe dl suatu periksean spt dl petandengan
ga.bah	gabah, sekam:
ga.buk	mandol, tak dapat anak:
ga.bung	gabong; ikat, berkas:
ga.bus	gabos I sejenes ati kayu yg lunak untok sumbat botol dsb,
ga.dai	gadai: gadai tanpa izin yg berwajib: gandai gelap
ga.ding	gadeng:
ga.dis	gades; dare; yang; perawan:
ga.do-ga.do	gado-gado
ga.duh	gadoh;
ga.du.ngan	palsu; tak asli; tiruan;
ga.et	ngaet; menarek dan mawak
ga.gah	gagah; kuat; pekase:
ga.gak	gagak; name burong bewarne itam yg selalu makan bangkai
ga.gal	gagal; tak berasel; tak tecapai (maksod):
ga.gang	 gagang; tangkai; ulu; solo: -
ga.gap	gagap; becakap tesendat-sendat:
ga.ga.san	pendapat; usol; pikeran:
ga.ib	gaeb; aneh; ganjel:
ga.i.rah	gairah; semangat
gait	gaet; tarek (terek); soket;
ga.jah	gajah; name binatang yg bebelalai; begadeiig, dan bekulet tebal
ga.ji	gaji; upah:
ga.lah	galeh; penyoket; penyolok:
ga.lak	galak; ganas; jahat; garang
ga.lak.si 	tate surye: teleskop itu sanggup memotret  yg jauh
ga.lang	galang; ganjal
ga.li	gali; korek
gam.bar	gamba; lukesan: 
gam.bir	gambe:
gam.blang	jelas; nampak; nyate:
ga.me.lan	gambelan; alat musik jawe
ga.mit	sentuh dng jari
gam.pang	mudah, senang; tak susah enteng:
gam.par	nampa, mokol; nempeleng:
ga.nas	ganas; kejam;jahat; galak:
gan.da	kali; lipat:
gan.dar	ganda; penganda:
gan.deng	gandeng; sambong; bimbeng:
gan.drung	rindu cinte; sayang:
gan.dum	gandom; terigu:
gang	gang; jalan kecik; lorong; jalan setapak
gang.gang	ganggang, aga-aga laot
gang.gu	nganggu, kacau, usek, gode;
gan.jal	ganjal; galang;
gan.jar	adiah, upah atau ukoman,
gan.jil	ganjel; tak genap; aneh, ajaeb:
gan.tang	gantang; alat penyukat beras, gule, dsb
gan.teng	tampan  elok dan gagah pekase:
gan.ti	ganti; tuka:
gan.tung	gantong; sangkot:
ha.bis	abes, tak ade lagi, slap; tamat:
ha.dap	adap; jumpe;
ha.di.ah	hadiah; piale:
ha.dir	ade; datang:
ha.di.rin	semue orang yg datang, hadirin:
ha.dis	hades; sabde dan pebuatan Nabi Muhammad saw yg diriwayatkan oleh sahabatnye
ha.fal	apal; ingat (masokkan di ingatan)
ha.fiz	pengapal Qoran; orang yg ngapal Qoran
ha.jar	pokol; itam; tumbok; bantai;
ha.jat	maksod tujuan; niat; keinginan; kehendak:
ha.ji	aji; ibadah yg dilakukan di tanah suci Mekah
hak	(yg) bona; betol; punye; milek:
ha.ki.kat	hakekat; intisari; dasa
ha.ki.ki	bena; sebenanye; sebetolnye; 
ha.kim	akem orang yg ngadelkan suatu pekare di mahkamah:
hal	hal; masalah; peristiwe; kejadian:
halal	halal; dibolehhkan; diizenkan:
hala.man	laman; pekarangan rumah dsb:
ha.lang	melintang; ngalang; nyegat; ngadang:
ha.Iau	alau; use; ambos;
ha.li.lin.tar	kilat; mate pete
hal.ma	halme;
hal.te	tempat berenti kerete api atau bas yg ade ruang tunggu yg beratap dan lebih kecik dp stasion
hal.ter	alat olah rage angkat besi berupe batang besi yg kedue ujongnye diberi besi pemberat dng ukoran berat tetentu
ha.luan	aluan; arah; tujuan
ha.lus	alos; tak kasa; kecik; licen; lembot:
ha.lu.si.na.si 	keadean seolah-olah nengok atau nenga sesuatu yg sebetolnye tak ade; bayangan; perasean
ha.ma	ame; tepiras; kutu yg ngisap darah spt pd ayam, kuceng, dsb;
ham.ba	ambe (hambe); abdi; budak belian; babu; kuli; aku (saye):
ham.bar	amba; tak ase rase:
ham.bat	ambat, tahan, cegat; rintang; keja,
ham.bur	tabo; teba; seba;
ha.mil	ngandong; bunteng:
ham.pa	tak berisi, kosong, hampe:
ham.pir	hampe, nyareh tecerapas; sikit lagi:
han.cur	anco; bekecai, lumat; remok:
han.duk	andok, tuala, kaen pengesat badan setelah mandi:
ha.ngat	angat; panas
ha.ngos	angos; gosong, 
han.sip	petahanan sipel
han.tam	tinju; tumbok; tam; langga; embat,
han.tu	antu;jembalang; puake, penunggu
ha.nya	hanye; cume:
ha.nyut	anyot; dibawak ae (aros):
ha.pus	apos, lap:
ha.ram	haram; tak halal; dilarang (di Islam):
ha.rap	arap; mohon; mintak; endaldah:
har.fi.ah 	tejemahan, arti menurot hurop, kate demi kate arti kate:
har.ga	rege:
ha.ri	arti: Senin, 
i.a.lah	ielah; yaitu; yakni;
i.ba	ibe; kasian; terharu sedih:
i.ba.dat	ibadat; ibadah;
i.ba.rat	ibarat; serti; umpame; macam; 
i.bi.dem	di karangan yg same spt buku, dsb;
ib.lis	ibles, setan; roh jahat;
i.bu	mak; ibuk, sebotan untok orang betine yg melahekan kite:
i.dam	idam keinginan eodak makan sesuatu 
i.dap	ngidap; selalu saket-saket; ke; menderite:
i.de	pendapat; gagasan; usol:
i.de.al	sangat sesuai ; sangat cocok;
i.de.a.lis	orang yg becite-cite tinggi;
i.dem	same dng di atas
i.den.ti.fi.ka.si	pebuatan nganggap same dl rupe (semangat, pandangan, dsb);
i.den.tik	same betol; tak ade bede; persis; serupe:
i.den.ti.tas	ciri-ciri; kekhasan; tande-tande:
i.de.o.lo.gi	landasan; dasa negare; paham:
i.gau, mengigau	ngigau; meracau;
i.ja.sah	ijazah; surat tamat belaja
i.juk	ijok; serabot (pd pangkal pelepah) pd pokok kabong;
i.kal	ikal; begelombang; bepintal-pintal:
i.kan	ikan;
i.kat	ikat; kebat:
ikh.las	ikhlas; tulos; rele; betot-betol:
ikh.ti.ar	ikhtiar; usahe (ushe):
ikh.ti.sar	ringkasan; intisari
ik.lan	reklame; tarek:
ik.lim	cuace; iklem; hawe:
ik.rar 	janji, sumpah:
ikut	ekot; turot; serte:
i.la.hi	Tuhan; Allah:
ile.gal	gelap; tak nurot ukom; tak sah; haram:
il.ham	ilham; petunjok dr Tuhan:
il.mi.ah 	besifat elmu; secare elmu pengetahuan:
il.mu	elmu; kepandaian;
i.lu.si	salah tengok; penglihatan yg tak sesuai dng mate;
ilus.tra.si	gamba-gamba untok mantu nyelaskan isi buku, karangan, dsb; penjelasan;
ilus.tra.tif	besifat nerangkan, nyelaskan, ngias
i.ma.ji.na.si 	daye khayal; angan-angan:
i.ma.ji.ner	besifat khayalan;
i.mam	imam;pemimpen waktu shalat; pemimpai; pengulu:
i.man	iman; keyakenan dan pecaye kpd Allah; ketegohan ati:
im.bal	balasan; upah (untok malas jase):
im.bang	imbang; same kuat (berat); tak berat sebelah;
i.mig.ran	orang yg datang netap di suatu negeri
i.mig.ra.si	pindah masok ke suatu negen untok netap (tinggal)
im.pit	empet; rapat; desak;
im.pli.ka.si	keadean telibat;
im.pli.sit	temasok (tekandong) di dalamnye
im.por	barang yg masok dari negare asing; 
ja.bar	jaba;
ja.bat	pegang; jabat;
ja.bata.ngan	bejabat tangan; besalam-salaman:
ja.di	jadi; tak bakal; siap; yg lah siap:
jad.wal	jadual, dafta; tabel ricane kegiatan dng magi waktu kerje yg teliti:
ja.ga	jage; tak tido; bangon:
ja.gal	pedagang kecik (spt di kedai dsb):
ja.gat	jagat; alam; dunie dan akherat:
ja.go	Iihai; pandai; kuat; pinta;
ja.gung	jagong; name tanaman yg buahnye diselimot bijik-bijik bewame kung
ja.ha.nam	jahanam; kurang aja; tekutok:
ja.hat	jahat; benges:
ja.hit	jaet;
ja.il	dengki; asat;jael; sukejahat atau ganggu:
ja.is	diizen oleh agame (boleh dibuat boleh juge tidak);
ja.ja	aje;jual;
ja.jah	ajah; pegi ke suatu daerah dr kota ke kota, dr dese ke dese; betualang;
ja.jak	duge; kire; sangke; agak;
ja.jar	jaja; bares; deret;
jak.sa	akse; pegawai pemerentah yg nuntot pekare di pengadelan'
ja.la	jale; alat nangkap ikan yg berupe jareng bulat dng care nebakan ke ae,
ja.lan	jalan; tempat lalu lintas orang, dsb;
ja.lang	jalang; ngengade; lia; miang:
ja.lin	jalen; gabong; ubong; rangkai;
ja.lur	jalo; gares; lorong: -- hitam, 'lorong itam'
jam	jam; arloji; alat nguko waktu
ja.mah	jamah; sentoh; rase; merabe; megang;
ja.mak	biase; lazem; tak eran; lumrah:
jam.ban	jamban; kakos, tandaas;
jam.bret	renggot; rebot; rampas;
jam.bu	jambu; name buah yg macam dan jaiesnye banyak spt jambu bol, dsb
ja.min	jamen; tanggong;
jam.pi	jampi-jampi; mantra; gune-gune:
ja.mu	jamu, obat periok; obat yg dibuat dr aka-aka; daon, dsb:
ja.mur	siawan: -- tekukur, 'siawan tekuko';
jan.da	jande
ja.ngan	jangan; tak boleh; 
ja.ngat 	kulet lua (rotan, kayu, binatang, manusie, dsb);
jang.gal 	janggal; aneh; tak sedap ditengok; 
jang.gut	janggot; jenggot; rambot yg tumboh di dagu: 
jang.ka 	angke; ukoran waktu tetentu waktu:
jang.kar	saoh; alat yg berat pd kapal yg dicampak ke laot waktu berenti supaye tak gelek atau anyot:
jang.kau	jangkau; capai;
jang.kit	bejangket nula, pindah.
jang.kung	jangkong tinggi: 
ja.nin	janen; bakal bayi (masih di kandongan)
jan.ji	janji; kata yg menyatekan kesediean dan sanggop untok bebuat sesuatu;
jan.tan	jantan; lekaki
jan.tung	jantong bagian tuboh sbg pusat peredaran darah (letaknye dl rongge dade sebelah atas): p
ja.nu.a.ri	januari, name bulan petame taon Masehi
ka.bar	kaba; berite; tau:
ka.bel	kabel; wayar; kawat penganta arus listrik
ka.bin	kamar (bilek) dl kapal;
ka.bi.sat	kabisat;
ka.bul	kabol; lulos; beri;
ka.bung	bekabaig; beduke cite 
ka.bu.pa.ten	kabupaten
ka.bur	kabur; belari lekas-lekas; melarikan diri
ka.but	kabot, kelam, kabos, suram
ka.ca	kace, cermen, bende yg keras
ka.cau	kacau campo; adok; bancoh, tak aman; tak tenteram:
ka.dar	kuase kekuatan; mampu:
ka.der	pewira atau bintara dl tentara 
ka.fan	kapan; kaen untok mungkos mayat: '
ka.fe	kedai kopi:
ka.get	terperanjat; tekejot:
ka.gum	kagom; salot; takjob; heran:
ka.i.dah	kaedah; atoran yg tetentu patokan:
ka.il	kael; kedek; panceng;
ka.in	kaen, barang yg lab ditenun spt kaen sarong
ka.is	kaes; karai; nyata tanah untok nyarik makan;
ka.it	kaet;
ka.ji	kaji; belaja; teliti;
kakak	kakak; kak; bah
ka.kek	tok; datok; bapak dr ayah atau mak;
ka.ki	kaki; anggote badan yg nopang dan dipakai untok bejalan (dr pangkal pahe ke bawah),
ka.ku	kaku; biga; kejang; keras tak dapat dilento:
ka.lah	kalah; tewas; tak menang; gagal:
ka.lap	lupe diri; tak ingat (ketike marah):
ka.lau	kalau; jikalau; bile; jika:
kal.bu	kalbu; ati; ati yg suci:
kal.de.ra	kawah gunong berapi yg sangat besa yg tejadi karene meledak atau runtoh bagian puncak gunong
kal.du	e (kua) dageng yg direbos
ka.lem	 tenang; santai; tak tegese-gese:
kalen.der	kelender; daftar ari dan dan serte tanggalnye:
ka.leng	kaleng; gayong: -- susu, 'gayong susu';
ka.li.mat	kalimat; kesatuan uja yg ngungkapkan pikeran atau perasean
ka.lung	kalong; rantai: -- tangan, 'rantai tangan';
ka.lut	kacau; kusot tak keruan; tak tentu arab:
ka.mar	kamar; bilek; ruang;
kam.buh 	saket lagi; datang lagi (saket yg lebth parah dr dulu)
ka.me.ra	kodak; alat untok ngamba:
ka.mi	kami; kate ganti orang petame jamak
ka.mis	kames; an yg kelime:
kam.pa.nye	 kompanye; gerakan (tindakan) serentak (untok melawan, dsb):
ka.mu	kau; dikau engkau; kate ganti orang kedue tunggal:
ka.muf.la.se	perubahan sikap, bentok, rupe, wame, dsb jadi laen agar tak dikenal;
ka.mus	kamos;
ka.nan	kanan; lawan kiri:
kan.cah	kawah; kuali besa; keadaan susah; tempat:
la.ba	selieseh antare rege penjualan yg lebeh besa dan rege pembelian atau biaye produksi
Ia.bah-Ia.bah	serangge besa bekaki lapan bewama abu-abu agak itam yg blase muat jaring dr belang sutre yg dikeluakan dr perotnye untok nangkap mangse;
Ia.bel	lebel; cap:
la.bi.al	bekaetan dg bunyi yg tejadi kerane penyempetan jarak antare bibe atas dan bme bawah
la.bil	goyah; gusa; tak tetap; tak kuat; giyang;
la.bi.um	bibe
Ia.bo.ran	orang (ahli kimia dsb) yg bekerje dekat labor
la.bo.ra.to.ri.um	labor; tempat (ruangan) yg lengkap dg alat untok penyelidekan, mal
lab.rak	itâm; gebuk; libas;
la.bu	labu; buah bedagang yg di bagian lua kuletnye keras
la.buh	laboh; amat panjang (ttg pakaian):
la.ci	laci; kotak kecik pd meje, gerobok
lan.cur	melaco; nyual diri; bebuat spt betinejalang;
la.da	lade; buah yg pedas rasenye dan bemacam jenes atau bentoknya
la.dang 	kebon: pak tani menanami—nya, 'pak tani nanam kebon di;
la.fal	ucap; care seseorang atau masyarakat menggunekan bahase;
la.ga	lage; adu; langga:jg takut
la.gak	lagak; engkek (mengkek); gaye:
la.gam	ragam, langgam; lagu; care
la.gu	lagu; nyanyian; lagam:
la.had	cerok (pd lubang kubo untok meletakkan mayat);
la.han	lahan; kebon; tanah:
la.hap	lahap; rakos; selere; suke makan;
la.har	laha; lumpo batu yg kelua dr kawah guong berapi
la.hir	lahe; kelua dr perot (kandongan):
Ia.hi.ri.ah	lahenye; tampaknye; besifat lahe
la.in	laen; bebede; tak same;
la.jang	lajang; bujang; belom kawen:
la.ju	lajul cepat; deras:
la.jur	lajo; deret; bares:
la.ki-la.ki	lelaki; jantan; kejantanan:
lak.nat	tekutok:
la.kon	pemeran,
lak.sa.na	laksane; bagaikan; bak;
lak.to.sa	gule yg ade di susu
la.ku	pebuatan; gerak-gerek; kelabu; tindakan:
la.lai	lalai; lupe; lengah; lemban; manai:
la.lang	lalang; rumpot yg tinggi dan besa
la.lap	ulam;
la.lat	lalat; serangan kecik berasal dr bernga dpt terbang,
la.lim	benges; kejam; zalem; tak add; tak naroh belas kesian'
la.lu	lalu; lewat:
la.lu-la.lang	lalu lalang lalu lintas; monda-mande;
la.ma	lame; lambat:
la.mar	melama; mintak wanite untok dijadikan bmi;
la.mat-la.mat	sama-sama; kabo; tak nyate nampaknye:
Iam.bai	melambai; beroyon-ayon turon naek (spt dao nio);
lam.ban	lemban; lengah; tak lekas; lembam:
lam.bang	lambang; gamba; tande yg mengandong maksod:
lam.bat	lambat; lemban; lame; pelan-pelan; tak lekas
ma.af	maaf; ampon:
ma.buk	mabok; nanéng; télér
ma.cet	sendat (tesendat); tak pakai (tak makan):
ma.dat	candu; nageh; madat:
ma.du	madu; caeran yg manes-pekat spt madu lebah
ma.fia	kelompok penjahat 
ma.gang	calon pegawai pd suatu tempat (kanto) yg masih taraf belaja
ma.gis	sakti; tuah; ajeab:
mag.ma	caeran batu pd kerak bumi yg panas
mag.net	besi berani:
ma.ha.gu.ru	mahe guru; guru besa; cek gu besa:
ma.ha.ku.a.sa	mahekuase; teramat kuase; teramat agong
ma.hal	mahal; tinggi regye:
ma.ha.sis.wa	orang yg belaja di peguruan tinggi;
ma.hir	mahe; telateh; pandai; paseh
mah.ka.mah	mahkamah; pengadelan; tempat mutoskan ukom kpd tedakwe
mah.ko.ta	mahkote; songkok kebesaran; kehormatan:
mahli.gai	mahligai; tempat diam raje sekeluarge di istane
main	maen; melakukan sesuatu untok menyenangkan ati;
ma.ja.lah	majalah; buku yg berisi berite dsb
ma.jelis	majeles; ruangan; sidang; rapat:
ma.je.muk	majemok; tejadi dr beberape bagian yg merupekan kesatuan
ma.ji.kan	tuan; toke; orang dsb yg menyediekan tempat kije:
ma.ju	maju; ke muke, ke depan:
ma.ka 	make; kate pengubong untok menyatekan ubongan akibat
ma.ka.lah	tulesan resmi ttg suatu masalah untok dibace di muke umom (dipelumbekan) dan adejuge yg dibukukan
ma.kam	makam, kubo; keramat:
ma.kan	makan, radak:
ma.kar	akal busuk; tipu muslihat;
ma.ke.lar	perantare pedagangan
ma.ket	model; pola:
makh.luk	makhlok; ciptean:
ma.ki	maid; caci, caci maid;
ma.kin	maken, semaken:
mak.lum	maklum; paham; ngerti; tau:
mak.lu.mat	pengumoman; pemberitauan;
mak.mum	makmom; pengikot imam dlm semayang
mak.mut	makmo; sejehtere
mak.na	makne; arti; maksod; tujuan:
mak.ro	besa; leba; luas; panjang
mak.si.at 	maksiat; yg bedose; pekerjaan yg betentang dg perentah Allah:
mak.si.mal	tetinggi; banyak; setinggi-tingginye
mak.si.mum	sebanyak-banyaknye; paling banyak; paling tinggi; 
mak.sud	maksod; tujuan; mat; hajat: kami datang membawa -, 'kami datang mawak hajai;
ma.lah	malah; bahkan; malahan
ma.lam	malam; gelap; 
ma.lang	malang; sial; celake; biase burok: hidupku selalu --, 'idopku selalu sial';
ma.la.ri.a	demam gigel:
ma.las	malas; manai; tak endak keije:
ma.lu	segan:
ma.ma.li.a	binatang menyusui
